0000000000100101100000100110110110000100010101100000000110010000
0000111100001101100101000100010000000001000001001000000010100010
0100000000101000000000000000001000010001001000000000000100111011
1001100000100010000000100000000110000000000100000000100100010000
1101010011100010101001001000000010100000001000010001000011010000
0001100010011100011010001000001011010101111000101100101011101000
0011011001011001011100010000000101011001001001011100011110000000
0001110001001001000010100100000000101010011000010010010110011001
0110110011101000011101010001011101010010000000101101000000000000
0000101000001000110001101100001001001001001110101011000001101010
0001101010010010100100110001110010100011100000000100101101100001
0010101000110110011010011000000000000000010100000010010000010110
1010100000101001111011001101101000011000100000100001011000000101
0011001000010000000000001000011100000011000001000001000010110001
0100010000000111000010001101000010001001100101101000001110001011
0110101100001000001000000011010000101101000000001100010001000000
0010100100010101101000111000101010100000110011100001000001010100
0111100001000100100000000010010000100000010010001001100011001000
0000010000110011000100000000000010000000010000000010100010000000
0101000010100101001010001000001000010000110010000100100100000001
0000000010101000000110011001100011001000000110010110010100100000
1000100010100000000001011000000000110010000000010000100100101000
0100000011011000110001011110000010100000100000100000111001000100
0010000101000000000010000100111000001000000101000101000100001010
0000101010001000011000010111000010000000000000100000010000100000
0001001100100110000000001100110010100111000000000101001010000010
0010000101001101001000100100001010111001000100010100100000101001
0010000111100000000010110000110010001000100000000101011011110010
1111011000010100110110001000000000111010000111101000000010101000
0001100001001000101010100010010000100110011001111000000100001011
0000000000011000000001001100000010100000001000000100000000000100
0000110110010110100000100110011000110010001110110101101100000010
0001000011100000001000010010100000100010000000110000000001001001
0000001000010000011000001000001110001000010010010001010000101110
0000000001000110100001011010100000011010000000000000000001101000
0010000110000000011000000000011001000000000001101000000000110010
0111001000110011100100101010001001000100000100000000100000000010
1000001111000000100001011100101101001110010100010010101000000011
0011010000000110100001100011111010000000101001001000001000101000
1010100000100110100000101100010000110000010110000000010000010000
1000111100110000111000110000000000000001010010010010100100011000
0101110100101000010000100111100000000001100000001010000001000000
1010100000000000010001000100110000000000001000000000000011000001
0010001101110011000001000001000010011100010000000001001010101011
0000010011000100011000100001001100000001000110111000000100000001
0010010110000000111010000000100100000001000000100000010000000000
0010000010000010000101000001000100001000101000000000011000100000
0000100010001100001010010100001010000000000000011100110110100000
0000100000100110000000000010000111000000000100111000100010100010
0111111000111101010101011000010000000010001000111110000000011011
0000100000101011001101110000010010000100000001000100100000101000
1000100001001000100100100000000001000000000010000101000000101100
0110010010101001000000000010100000000010001100000110000011010010
0100001000110001000001000100010000100000100110000010111001000011
0110000000000001100000001000010010100100010011000010010011000100
0001001001001000001000000011000100000100010011001000010010010000
1101100100000000010110010001001111001000001000000100110010010001
1000110010000000100000010001100110001100100100010010000101000100
0100000000001000000101001001101000001110001010010000110000001101
1011000000000000010000000001001110000001000100000010000100001011
1011000100000110100001001100001011001101000001101010000010000111
1000000000000101000001001000011010000100001010001001100011001000
0001100000001100100000011100011011000010100101000101000110001011
0101001010001001100010000000100100100000001010011000100010000100
